NO texture/wood.xpm
SO texture/wood.xpm
WE texture/wood.xpm
EA texture/test.xpm

F 20,20,20
C 200,200,200

111111111111111111111
1000000000000000000N1
100000000000000000001
111111111111111111111
