                
                                                 SO                 texture/marta.xpm     



                F 11,195,127                                      

                        
                


                




                NO          texture/marta.xpm  
                 


                        
        
                                        C 58,212,243   
               
               EA                             texture/wood.xpm                                                                                                         
        
 
                        


                         
                        
                        WE                       texture/wood.xpm
        1111111111111111111111111                                                                     
        1000000000110000000000001111111111                                  
        1011000001110000000000E0000000001                  
        1001000000000000000000001111111001                                                                                                            
111111111011000001110000000000001   1 100111111                                                
1000000000110000011101111101111111110110000001                                                                        
11110111111111011100000010001       1 100000001                            
11110111111111011101010010001         100000001    
11000000110101011100000010001111111111111111111 
10000000000000001100000010001                                                            
1000000000000000110101001001      
110000011101010111110111100111 
11110111 1110101 101111010001               
11111111 1111111 111111111111  
