                
                                                 SO                 texture/wall1.xpm     



                F 162,0,8                                       

                        
                


                




                EA          texture/wall2.xpm  
                 


                        
        
                                        C 161,15,125   
               
               NO                              texture/wall1.xpm                                                                                                         
        
 
                        


                         
                        
                        WE                       texture/wall3.xpm
        1111111111111111111111111                                                                     
        1000000000110000000000001111111111                                  
        1011000001110000000000000000000001                  
        1001000000000000000000001111111001                                                                                                            
111111111011000001110000000000001     100111111                                                
1000000000110000011101111101111111111110S000001                                                                        
11110111111111011100000010001         100000001                            
11110111111111011101010010001         100000001    
11000000110101011100000010001         111111111 
10000000000000001100000010001                                                            
1000000000000000110101001001      
110000011101010111110111100111 
11110111 1110101 101111010001               
11111111 1111111 111111111111  
